------------------------------------------------------------------------------------------------------------------------------------------------------------------------------------------------------
------------------------------------------------------------------------------------------------------------------------------------------------------------------------------------------------------
------------------------------------------------------------------------------------------------------------------------------------------------------------------------------------------------------
------------------------------------------------------------------------------------------------------------------------------------------------------------------------------------------------------
------------------------------------------------------------------------------------------------------------------------------------------------------------------------------------------------------
-------------------------------------------------------------------------------------SSS------------------------------------------------------------------------------------------------XX------------
--------------------------------------------------------------------------------------------------------------------------------------------------------E-------------------------------XX------------
-------------------------------------------------------------------------------------------------------------------------------------------------------<>-------------------------------XX------------
-------------------------------------------------------------------------------------------------------------------------------------------------------[]----------------------------X--XX------------
----------------------------------------E------E-------------------------------E----XXXXX-----------------------------------------------------XSSS-----XX---------------------------XX--XX------------
---------------------------------------<>-----<>----E--------------------------E----X--------------------------X------------------------------X----------------E-----------E----E--XXX--XX------------
---------------------------------------[]-----[]------------------------------------X---------------------X----X------------------------------X-----------X---<>-----X------------XXXX----------------
----------E--E-EE-------EE-E-----E-----[]-----[]-----------EEE------EE-E------------X-------------EE-E----X----X---EE-E--E------E----------E-EX-----------X---[]-----X-----------XXXXX------------X---
XXXXXXXXXXXXXXXXXXXXXXXXXXXXXXXXXXXXXXXXXXXX--XXXXXXXXXXXXXXXXXXXXXXXXXXXXXXXXXXXXXXXXX----XXXXXXXXXXXXXXXXXX--XXXXXXXXXXXXXXXXXXXXXXXXXXXXXXXXXXXX---XXXXXXXXXXXXXXXXXXXXXXXXXXXXXXXXXXXXXXXXXXXXXXXX
